BACK	B AE K
DOWN	D AW N
FIVE	F AY V
FOUR	F AO R
HOME	HH OW M
LEFT	L EH F T
MUTE	M Y UW T
NEXT	N EH K S T
NEXT(2)	N EH K S
PAUSE	P AO Z
PLAY	P L EY
PREVIOUS	P R IY V IY AH S
RIGHT	R AY T
SELECT	S AH L EH K T
SHUFFLE	SH AH F AH L
STOP	S T AA P
THREE	TH R IY
TWO	T UW
UNMUTE	AH N M Y UW T
UNSHUFFLE	AH N SH AH F AH L
UP	AH P
